30 32
#############################
#                           #
# # # # # # # # # # # # # # #
#                           #
# # # # # # # #
#                           #
# # # # # # # #
#                           #
# # # # # # # #
#                           #
# # # # # # # #
#                           #
# # # # # # # #
#                           #
##############################
