9 26
########################
#                      #
# ## #  # ### ## #   # #
# #  ## # #   #  ## ## #
  ## # ## ### ## # # #  
# #  #  #   # #  #   # #
# ## #  # ### ## #   # #
#                      #
########################
