15 17
###############
#             #
# # # # # # # #
#             #
# # # # # # # #
#             #
# # # # # # # #
#             #
# # # # # # # #
#             #
# # # # # # # #
#             #
# # # # # # # #
#             #
###############
